0000000000000000000000000000000000000000000000000000000000000000000000000000000000000000000000000000
0000000000000000000000000000000000000000000000000000000000000000000000000000000000000000000000000000
0000000000000000000000000000000000000000000000000000000000000000000000000000000000000000000000000000
0000000000000000000000000000000000000000000000000000000000000000000000000000000000000000000000000000
0000000000000000000000000000000000000000000000000000000000000000000000000000000000000000000000000000
0000000000000000000000000000000000000000000000000000000000000000000000000000000000000000000000000000
0000000000000000000000000000000000000000000000000000000000000000000000000000000000000000000000000000
0000000000000000000000000000000000000000000000000000000000000000000000000000000000000000000000000000
0000000000000000000000000000000000000000000000000000000000000000000000000000000000000000000000000000
0000000000000000000000000000000000000000000000000000000000000000000000000000000000000000000000000000
0000000000000000000000000000000000000000000000000000000000000000000000000000000000000000000000000000
0000000000000000000000000000000000000000000000000000000000000000000000000000000000000000000000000000
0000000000000000000000000000000000000000000000000000000000000000000000000000000000000000000000000000
0000000000000000000000000000000000000000000000000000000000000000000000000000000000000000000000000000
0000000000000000000000000000000000000000000000000000000000000000000000000000000000000000000000000000
0000000000000000000000000000000000000000000000000000000000000000000000000000000000000000000000000000
0000000000000000000000000000000000000000000000000000000000000000000000000000000000000000000000000000
0000000000000000000000000000000000000000000000000000000000000000000000000000000000000000000000000000
0000000000000000000000000000000000000000000000000000000000000000000000000000000000000000000000000000
0000000000000000000000000000111111111111111111111111111100000000000000000000000000000000000000000000
0000000000000000000000001111100000000000000000000000000111111111111000000000000000000000000000000000
0000000000000000000011111000000000000000000000000000000000000000001111000000000000000000000000000000
0000000000000000001110000000000000000000000000000000000000000000000001110000000000000000000000000000
0000000000000000111000000000000000000000000000000000000000000000000000011100000000000000000000000000
0000000000000011100000000000000000000000000000000000000000000000000000000111000000000000000000000000
0000000000000110000000000000000000000000000000000000000000000000000000000001100000000000000000000000
0000000000001100000000000000000000000000000000000000000000000000000000000000110000000000000000000000
0000000000011000000000000000000000000000000000000000000000000000000000000000011000000000000000000000
0000000000010000000000000000000000000000000000000000000000000000000000000000001100000000000000000000
0000000000110000000000000000000000111111111111111110000000000000000000000000000110000000000000000000
0000000000100000000000000000000111100000000000000011111110000000000000000000000011000000000000000000
0000000001100000000000000000111100000000000000000000000011110000000000000000000001000000000000000000
0000000001000000000000000011100000000000000000000000000000011110000000000000000001100000000000000000
0000000011000000000000000110000000000000000000000000000000000011000000000000000000110000000000000000
0000000010000000000000001100000000000000000000000000000000000001100000000000000000010000000000000000
0000000010000000000000011000000000000000000000000000000000000000110000000000000000011000000000000000
0000000010000000000000110000000000000000111110000000000000000000011000000000000000001100000000000000
0000000010000000000001100000000000001111100011111110000000000000001100000000000000000100000000000000
0000000110000000000011000000000000111000000000000011100000000000000110000000000000000100000000000000
0000000100000000000010000000000001100000000000000000111000000000000011000000000000000110000000000000
0000000100000000000110000000000011000000000000000000001110000000000001100000000000000010000000000000
0000000110000000000100000000000110000000000000000000001011000000000000110000000000000011000000000000
0000000010000000000100000000001100000000000000000000000001110000000000010000000000000001000000000000
0000000010000000000100000000001000000000011111111110000000011000000000011000000000000001000000000000
0000000010000000000100000000011000000000110000000011100000001100000000001100000000000001100000000000
0000000010000000000100000000010000000001100000000000110000000100000000000100000000000000100000000000
0000000010000000000100000000010000000001000000000000011000000110000000000100000000000000100000000000
0000000010000000000100000000010000000001000000000000001000000010000000000110000000000000100000000000
0000000010000000000100000000010000000001000000000000001100000011000000000010000000000000100000000000
0000000010000000000100000000010000000001000000000000000100000001000000000011000000000000110000000000
0000000011000000000100000000010000000001000000000000000100000001100000000001000000000000010000000000
0000000001000000000100000000010000000001100000000000000100000000100000000001000000000000010000000000
0000000001000000000100000000010000000000100000000000000110000000100000000001000000000000010000000000
0000000001000000000100000000010000000000110000001100000010000000110000000001100000000000010000000000
0000000001100000000110000000011000000000011111111000000010000000010000000000100000000000010000000000
0000000000100000000010000000001000000000000000000000000010000000010000000000100000000000011000000000
0000000000100000000010000000001000000000000000000000000010000000010000000000100000000000001000000000
0000000000110000000011000000001100000000000000000000000010000000010000000000100000000000001000000000
0000000000010000000001100000000100000000000000000000000110000000010000000000100000000000001000000000
0000000000010000000000100000000110000000000000000000000100000000010000000000100000000000001000000000
0000000000011000000000110000000011000000000000000000000100000000110000000000100000000000001000000000
0000000000001000000000011000000001100000000000000000001100000000100000000000100000000000001000000000
0000000000001000000000001000000000110000000000000000001000000000100000000000100000000000001000000000
0000000000001100000000001100000000011100000000000000011000000001100000000000100000000000001000000000
0000000000000100000000000110000000000111110000000011110000000001000000000001100000000000001000000000
0000000000000110000000000010000000000000011111111110000000000011000000000001000000000000001000000000
0000000000000010000000000011000000000000000000000000000000000010000000000001000000000000001000000000
0000000000000010000000000001100000000000000000000000000000000110000000000001000000000000001000000000
0000000000000011000000000000110000000000000000000000000000001100000000000001000000000000001000000000
0000000000000001000000000000011000000000000000000000000000001000000000000011000000000000001000000000
0000000000000001100000000000001100000000000000000000000000111000000000000010000000000000001000000000
0000000000000000110000000000000111000000000000000000000011100000000000000010000000000000001000000000
0000000000000000010000000000000001111000000000000000011110000000000000000110000000000000001000000000
0000000000000000011000000000000000001111110000000001110000000000000000000100000000000000001000000000
0000000000000000001000000000000000000000011111111111000000000000000000001100000000000000001000000000
0000000000000000001100000000000000000000000000000000000000000000000000001000000000000000001000000000
0000000000000000000110000000000000000000000000000000000000000000000000011000000000000000001000000000
0000000000000000000011000000000000000000000000000000000000000000000000110000000000000000001000000000
0000000000000000000001100000000000000000000000000000000000000000000000100000000000000000011000000000
0000000000000000000000110000000000000000000000000000000000000000000001100000000000000000010000000000
0000000000000000000000011100000000000000000000000000000000000000000011000000000000000000010000000000
0000000000000000000000000110000000000000000000000000000000000000001110000000000000000000010000000000
0000000000000000000000000011100000000000000000000000000000000000011000000000000000000000110000000000
0000000000000000000000000000111100000000000000000000000000000001110000000000000000000000100000000000
0000000000000000000000000000000111110000000000000000000000001111000000000000000000000000100000000000
0000000000000000000000000000000000011111111111111111111111111000000000000000000000000001100000000000
0000000000000000000000000000000000000000000000000000000000000000000000000000000000000010000000000000
0000000000000000000000000000000000000000000000000000000000000000000000000000000000000110000000000000
0000000000000000000000000000000000000000000000000000000000000000000000000000000000001000000000000000
0000000000000000000000000000000000000000000000000000000000000000000000000000000000010000000000000000
0000000000000000000000000000000000000000000000000000000000000000000000000000000001100000000000000000
0000000000000000000000000000000000000000000000000000000000000000000000000000001111000000000000000000
0000000000000000000000000000000000000000000000000000000000000000000011111111111000000000000000000000
0000000000000000000000000000000000000000000000000000000000000000000000000000000000000000000000000000
0000000000000000000000000000000000000000000000000000000000000000000000000000000000000000000000000000
0000000000000000000000000000000000000000000000000000000000000000000000000000000000000000000000000000
0000000000000000000000000000000000000000000000000000000000000000000000000000000000000000000000000000
0000000000000000000000000000000000000000000000000000000000000000000000000000000000000000000000000000
0000000000000000000000000000000000000000000000000000000000000000000000000000000000000000000000000000
0000000000000000000000000000000000000000000000000000000000000000000000000000000000000000000000000000
